----------------------------------------------------------------------------------------------------------------------------------------------------------D-----------------------------------------
----------------------------------------------------------------------------------------------------------------------------------------------------------------------------------------------------
---------------------------------------------------------------------------------------------------------------------------------------------------B------------------------------------------------
--------%-------------------------------------------------------------------------------------------------------------------------------------------------------------------------------------------
-----------E----------------------------------------------B--------------------------------------------------------------S-------------------------------------------------------------##-----------
-------------------------------------------------------------%---------------------------------------------------------b-----------------------------------------g---------------------##-----------
-----@---------------LSSS---------------------QQQQQ-----------USSS--------SSCSS------SSSS-----------------------------USSS-----------------------------------SESSS---?-------------C---##-----------
--------------------------------------------2----1------------------------------------------------------------------------------------------------Q--B---C-----------------------------##-----------
-----------------g---U--------------------L--------------------------------------------------------------------------------------------------------------------------------------1-----##-----------
-----------------#------------------------------k-----------------------------------------------g-------------------E------TT----------------------------------------------------------##-----------
--------SUS-----##---2-----#-----------TT-----?QQQQ----------L-----TT---QQQQ--QQQ---------------TT-----------------TT------TTy----------------------------C--------Q--------------SS---##-----------
---------------###---------#-----------TT--K-----------------------TT---------------------------TT----------g------TT--tt--TT--------------------g-#---------------------TT------------##-----------
--------------####---------##----------TT--------------------------TT---------------------------TT----------TT-----TT--tt--TT------------------K---#---------------------TT----1-------##--------F--
--M----------###U#----kk---##---gg-----TT------------gg----k-ggg---TT------------ggg------------TT----------TT--g--TT--tt--TT-----k----------------#-----gg-------K-K----TT--------k---##--U-----X--
XXXXXXXXXXXXXXXXXXXXXXXXXXXXXXXXXXXXXXXXXXXXXXXXXXXXXXXXXXXXXXXXXXXXXXXXXXXXXXXXXXXXX----XXXXXXXXXX---XXXXXXXXXXXXKXXXXXXXXXXXXXXXXX---XXXXXXXXXX--XXXXXXXXXXXXXXXXXXXXXXXXXXXXXXXXXXXXXXXXXXXXXXXXX
XXXXXXXXXXXXXXXXXXXXXXXXXXXXXXXXXXXXXXXXXXXXXXXXXXXXXXXXXXXXXXXXXXXXXXXXXXXXXXXXXXXXX----XXXXXXXXXX---XXXXXXXXXXXXXXXXXXXXXXXXXXXXXX---XXXXXXXXXX--bXXXXXXXXXXXXXXXXXXXXXXXXXXXXXXXXXXXXXXXXXXXXXXXX
