----------------------------------------------------------------------------------------------------------------------------------------------------------------------------------------------------
----------------------------------------------------------------------------------------------------------------------------------------------------------------------------------------------------
---------------------------------------------------------------U--------------------------------------------------------------------------?---------------------------------------------------------
----------------------------------------------------------------------------------------------------------------------------------------------------------------------------------------------------
---------------------------------------------------L------------------------------------------------------------------------------------------------------------------------------------------------
----------------------------------------------------------------------------------------------------------------------------------------------------------------------------------------k-----------
----------------------------------------------QQQQQ-----------USSS--------SSCSS------S------------------------------------QQQQ-b-------------------------------------------------------##-----------
---------------------------------------------------------------------------------------------oooo------------oooo---------------------------------------------------------------------###-----------
-----------------------------------------------------------E---------G----------------------------------E---------------------------------------------------------------------------k####-----------
------------Q--?--------------------------------k-----------------------------------------------------------------Q---------y------------------------------------------------------Y#####-----------
---------Q---------SSS-----#-----------TT-----?QQQQ------*---S-----TT---QQQQ--QQQ---------TT-%------------TT------------QQ?SSQQQ---------------------------------------------------######-----------
---------------------K----C#-----------TT--------------------------TT-*2------------------TT--------------TT-------------------------------------------------k--#-----------------#######-----------
---------------------------##----------TT--------------------------TT---------------------TT--------------QT--------------------------TT------------------------#----------------########--------F--
-M----------------K--------##---EE-----TT------------EE----k-EBE---TT------------EEE---y--TT---y------y---TT--------------------------TT------------------------#----y--y-------#########--------#--
XXXXXXXXXXXXXXXXXXXXXXXXXXXXXXXXXXXXXXXXXXXXXXXXXXXXXXXXXXXXXXXXXXXXXXXXXXXXXXXXXXXXX-XXXXXXXXXXXXXXXXXXXXXXXXXXXXXXXXXBXXX--XXXXXXXXXXXXXXXXXXXX---XXX--XXXXXXXX--XXXXXXX--XXXXXXXXXXXXXXXXXXXXXXXX
XXXXXXXXXXXXXXXXXXXXXXXXXXXXXXXXXXXXXXXYXXXXXXXXXXXXXXXXXXXXXXXXXXXXXXXXXXXXXXXXXXXXX-XXXXXXXXXXXXXXXXXXXXXXXXXXXXXXXXXXXYX--XXXXXXXXXXXXXXXXXXXX---XSX--XXXXXXXX--XXXXXXX--XXXXXXXXXXXXXXXXXXXXXXXX
