--E--L-----------------------Q-------------------------o--y-------------------------------------------------------------------------------------------------------K-----------------------%---------
----------------------------------------------------------------------------------------------------------------------------------------------------------------------------------------------------
----------------------------------------------------------E-----------------------------------------------------------------------------------------------------1-----------------------------------
----------------------------------------------------------------o----L--------------------------------%----------------------------------------------------------------------------------B-------2--
----------------------------------------------------------------------------------------------G--2------------------------------------------------?-------------------------------------------------
--------Uk---------------------------------------------------------------------*----B-----------------------k---------------------------------------------------------------------------k-----------
------------------------------------------------------------------1---------------2---------------------------------------QQQQ-------X-------------------------------------------------##------2----
----------------------------------------D---------------Q----------------------oooo----------oooo----------y-oooo-----------------------------------%------%--------------------------###-----------
----------------------B---------------------------------G------------------------------------------------------------------b--------------------------------------------#------*----k####-----------
------------C--?-------------------E-----------------------------------------------------------*--1-------------------------y-------------------------------------k-----#-----------#####-----------
---------QB--------SSS---------TT---------------------S---------QQQQ----------------------TT--------------TT------------QQ?SSQQQ-------------------------------SCSSS----#----------######--?--------
-------------------U-K--LTT----TT-----------------TT-------------------------#------------TT----------U---TT-----------Q-----------------------------------------K-----##---------#######-----------
-C-----------------------TT---2TT-----------------TT-------------------------#------------TT--------------TT--------------------------TT-------------------------------##--------########--------F--
-M----------------K------GT---ETT-o------------EEETT-------------yy----------#---------y--TT2--y------y--?TT---------L----------S-----TT-----------------------K---K--r##--2----#########--------#--
XXXXXXXXXXXXXXXXXXXXXXXXXXXXXXXXXXXXXX---XXXXXXXX2XXXXXXXXXXBXXXXXXXXXXXXXXXXXXXXXXXXXXXXXXXXXXXXXXXXXXXXXXXXXXXXXKXXXXXXXX--XXXXXXXXXXXXXQXXXXXX---XXX--XXXXXXXXXXXXXXXX---XXXXXXXXXXXXXXXXXXXXXXXX
XXXXXXXXXXXXXXXXLXXXXXXXXXXXXXXXXXXXXX---XXXXXXXXXXXXXXXXXXXXXXXXXXXXXXXXXXXXXXXXXXXXXXXXXXXXXXXXXXXXXXXXXXXXXXXXXXXXXXXXXX--XXXXXXXXXXXXXXXXXXXX---XXX--XXXXXXXXXXoXXXXX---XXXXXbXXXXXXXXBXXXXXXXXX
