----------G-------------------------D---------------------------------------------------------------------------------------------------------------------------------------------------------------
----------------------------------------------------------------------------------o-----------------------------------------------------------------------Q-----------------------------------------
----------------------*-------------Q-------------------r------b--------------------------------------------------------------------------------------------------------------------------------C---
---------------------G----------------------------------------------------------------------------------------------------------------------Q-------------------------------------------------------
---------------------------------------------------------------------------------------------------------------------------------------------------------------------------------------##-----------
-------------------------------------k---------------------------------------------------y--------b---------------------------------------------k--------------------------------------##-----------
----------------Q-----------------------------QQQQQ--o--------USBS--------SSCSS-k----SSSS---------------G-------------USSS---------------------SQS--b---#------------------------------##-----------
-----------------------------------------------------------------------C----E-------------------------------------X--------------------------------------------------------------------##-----------
--------K-----------------------------------------------?------------------------------------------------------------------------------------------------------------------------------##-----------
------D-----------------------------------------k-----------------------------------------------E-------------------E------TT-------1----------------------------------------------#---##-----------
----------------?------------o---------TT-----?QQkQ----------S-C---TS---QQQQ--QQQ---------------TT-----------------TT------TT--------------o---SQS------------------------------K-##---##-------#---
------------TT-----------Y-------------TT--------------------------TT---------------------------TT----------E------TT--tt2-TT-----------------------------------#----------------###---##-----------
------------TT-------------------------TT--------------------------TT---------------------------TT----------TT-----TT--tt--TT-----------------------------------#---------------#?##---##--------F--
-M----S-----TT------------------E#-----TT-------E----EE----k-EEE---TT------------EEE------------TT----------TT--E--TT--tt--TT-----k----------k------------------#----y--y---D--#####---##--------X--
XXXXXXXXXXXXXXXXXXXXXXX--XXXXXXXXYXXXXXXXXXXXXXXXXXXXXXXXXXXXXXXXX%XXXXXXXXXXXXXXXQXX----XXXXXXXXXX---XXXXXXXXXXXXXXXXXXXXXXX*XXXXXX---X-XXXXXXXXXX-XXX--XXXXXXXX--XXXXXXXXXXXXXXXXXXXXXXXXXXXXXXXXX
XXXXXXXXXXXXXXXXXXXXXXX--XXXXXXXXXXXXXXXLXXXXXXXXXXXXXXXXXXXXXXXXXXXXXXXXXXXXXXXXXXXX----XXXXXXXXXX---XXXXXXXXXXXXXXXXXXXXXXXXXXXXXX---X-XXXXXXXXXX-XXX--XXXX#XXX--XXXXXXXXXXXXXXXXXXXXXXXXXXXXXXXXX
