------------------------------------------------------------------------------------------------------------------------------------r---------------------------------------------------------------
----------------------------------------------------------#----------------------------------------------L-------------------------------------U-U---------------*----------------------------------
------------------Kb-------r----------------------------------------------o-------------------------------------------------------------------------------------------------------------------------
-------------------------------------------------b----------------------------------------------------------------------------------r----D---------------k------------------------------------------
------------1----------------------------D----------------------------------------------------------------------------------------------------------------------------------------------------------
----------------------------E-------------------------B----------------------------------------------------------------------------------------?k---------------------------------------k-----------
---------------------L--------------------Q-K-----X---------------1-------------------------------------------------------SSC------------------SQS--SQS------------------------------Y-##-----------
-----2-----------------------------------#-------------------------------------oooo----------oooo------------oooo-------K----------?------------------------#-------------------------###-----------
-------------------------y--------------------------------------------------------------------------------r--------------------------E#---------------------------------#-----------k####-----------
------------Q--?------------------------------------------------------k-------------------------------------Q-------------SSS-------E##---------------------------%-----#-----------#####--------?--
---------Q---------SSY---------TT---------Q-Q-------------------QQQQ----------------------TT--------------TT------------------------###--------SQS--S*S--------SCSSS----#-Q--------######-----------
---------------------K---TT----TT--------------------------------------------#-----y------TT------#-------TT-----------------------####--------------------------K-----##---------#######---------U-
-------------------------TT----TT--o---------------------------------#-------1------------TT-1------------TT----------------------#####-------------------U--------b---##------o-########--------F--
-M----------------K------TT---ETT----y--------y------------------yy----------#---------y--TT---y------y---TT---------------------######------k------EEE--------K---K---##-------#########--------#--
XXXXXXXXXXXXXXXXXXXXXXXXXXXXXXXXXXXXXXXXXXXbXXXXXXXX----XXXXXXXXXXXXXXXXXXXXyXXXXXXXXXXXXXXXXXXXXXXXXXXXXXXXXXXXXXXXXXXXX----XXXXXXXXXX--XXXXXGXXXXXXXXXXXXXXXXXXXXXXXXXX---XXXXXXXXXXXXXXXXXXXXXXXX
XXXXXXXXXXXXXXXXXXXXXXXXXXXXXXXXXXXXXXXXXXXXXXXXXXXX----XXXXXXXXXXXXXXXXXXXXXXXXXXXXXXXXXXXXXXXXXX1XXXXkXXXXXXXXXXXXXXXXX----XXXXXXXXXX--XXXXXXXXXXXXXXXXXXXXXXXXXXXXXXXX---XXXXXXXXXXXXXXXXXXXXXXXX
