---------------------------------------------------------------------------------------------------------------------------------o------------------------------------------------------------------
-------------y------------------------------------------------------------------------------------------D-----------------------------------1---------------------------------------------C---------
-------------------------2--------------------------y------------------------------------------------------------------------------------------------E----------------------------------------------
----------------------------------------------------------------------------------------------------------------------------------------------------------------------------------------------------
--------------------------------------------------------------------------------------------L-----------------------------------------------------------------------------------------X-#-----------
--------------------------------------------------------------------------------------------------------------------------------------------------------y-------------------------------#-----------
-----------------------------------------Y----QQQQQ-----------USSS--------SSCSS------EDSS---------------SSQSSS?SSS----USS?-----------------------------------SSSSS---?-------------C----#-----------
----------------------------------------------------------------------------------------------b------------------------------------------E----------------------------------------------#-----------
----------------------------------------------------------------------------------------------------------------------------------------------------------------------------------------#-----------
------------Q--?--------------------------------k-------------------------------------------------2-------K-----------------T-----------------------------------------------------------#-----------
---------Q---------SSS---------TT-------------?QQQQ----------S-----TT---QQQQ--QQQ---------------TT------SSSSSSSSSSS--------TT-------y---------------------C--------Q--------------SS---##-----------
---------------------K---TT----TT----------------------------------TT--o------------------------TT---------------------tt--TT------------------r---#---------------------TT------------##-----------
-------------------------TT----TT----------------------------------TT----------#-------------2--TT---------------------tt--TT------------------K---#----K----------------TT------------##--------F--
-U----------------K------TT---ETT--------------------EE----k-EEE---TT------------EEE--------k---TT--------------K------tt--TT-----k-----------B----k-----EE-------K-K----TT-----#--k---##--------X--
XXXXXXXXXXXXXXXXXXXXXXXXXXXXXXXXXXXXXX---LXXXXXXXXXXXXXXXXXXXXXXXXXXXXXXXXXXXXXXXXXXX----XXXXXXXXXXXXXXXXXXXXXXXXXXXXXXXXXXXXXXXXXXX---XXXXXXXXXX--XXXXXXXXXXXXXXXXXXXXXXXXXXXXXXXXXXXXXXXXXXXXXXXXX
XXXXXXXXXXXXXXXXXXXXXXXXXXXXXXXXXXXXXo---XXXXXXXXXXXXXXXXXXXXXXXXXXXXXXXXXXXXXXXXXXXX--y-XXXXXXXQXXXXXXXXXXXXXXXXXXXXXXXXXXXXXXXXXXX---XXXXXXXXXX--XXXXXXXXXXXXXXXXXXXXXXXXXXXXXXXXXXXXXXXXXXXXXXXXX
