----------------#-----------------------------------------------------------------------------------------------------------------------------------------------------------------------------------
----------------------------------------------------------------------------------------------------------------------------------------------------------------------------------------------------
-------------------------Y--------------------------------------------------------------------------------------------------------------------------------------------------------------------------
----------------------------------------------------------------------Y--------------------*--------------------------------------------------------------------------------------------------------
------------------------------------------------------------------------------U---------------------------------------------------------------------------------------------------------------------
------------------------------------------------------------------------------------------------------------------------------------------------k---------------------------------------k-----------
----------------Q-------------------------------QQQ-----------USSS--------SSCSS------SSSS-----------------------------USSS---------------------SQS--SQS--------------------------------##-----------
------------------------------------------------------------------------------------------------------------------------------%-------------------------------------------------------###-----------
------------------------------------------------------------------------------------------------------------------------------------------------------------------------#-----------k####-----------
------%-----------------------------------------k-----------------------------------------------E-------------------E-------T-------------------------------------k-----#-----------#####-----------
----------------?--------------TT--------------QQQQ----------S-----BT---QQQQ--QQQ---------------TT-----------------TT------TT---------#--------SQS--S?S--------SCSSS----#----------######-----------
------------TT------X-----T----TT----------------------------------TT---------------------------TT----------E------TT--tt--TT---------#--------------------------K-----##---------#######-----------
------------TT------------T----TT----------------------------------TT---------------------------TT----------TT-----TT--tt-STT------1--#--------------------------------##--------########--------F--
-M----------TT-------2----T---ETT--------------------EE----k-EEE---TT-C----------EEE------------TT----------TT--E--TT--tt--TTr----k---#-B----k------EEE--------K---K---##-------#########--------#--
XXXXXXXXXXXXXXXXXXXXXXX--XXXXXXXXXXXXX---XXXXXXXXXXXXXXXXXXXXXXXXXXXXXXXXXXXXXXXXXXXX----XXXXXXXXXX---XXXXXXXXXXXXXXXXXXXXXXXXXXXXXX--Y--XXXXXXXXXXXXXXXXXXXXXXXXXXXXXXXX---XXXXXXXXXXXXXXXXXXXXXXXX
XXXXXXXXXXXDXXXXXXXXXXX--XXXXXXXXXXXXX---XXXXXXXXXXXXQXXXXXXXXXXXXXXXXXXXXXXXXXXXXXXX----XXXXXXXXXX---XXXXXXXXXXXXXXXXXXXXXXXXXXXXXX-XX--XXXXXXXXXXXXXXXXXXXXXXXXXXXXXXXX---XXXXXXXXXXXXXXXXXXXXXXXX
