-------------------------%------------S------------------------------------------------------------------------------------------------------------------------------------------K------------------
--------------------------------------------------------------------------------X-------------------?---------------------------------------------G-------------------------------------------------
------------D------------%--------------------------------------------------------------------------------------------------------------------------------------------------------------------------
-----------------E----------------------2----B--------------------------------------Q------------------------------------------------2--------------------E------------------1-------------------G--
----------------------------------------------------------------------------------------------------------------------------------------------------------------------------------------#-----------
------------------------------------------------------------------------------------------1-------------------------------------S---S-------------------b-------------------------------#---X-------
------------------------------------------------------------------1-----------------------------------*-------------------QQQQ---------?----------------------------------k--------C----#-----------
-----------------X------------------------------C------------------------------oooo----------oooo------------oooo------------X----------------------------------------------------------#-----------
-------------------------------------B----------------------------------------#----------------------------------------------------------------X----------------------------------------#-----------
------------Q--?--------2---------------------------------------------------r--------Q--------------------------------------y----------------------C------------------------------------#-----------
---------Q---------SSS---------TT---------------------S---------QQQQ----------------------TT--------------TT------------QQ?SSQQQ-------C------------------------------------------SS---##-----------
---------------------K---TT2---TT-----------------TT-------------------------#------------TT--------------TT-------------------k--------------------------------#---------r------#-----##-----------
-----------------L-------TT----TT----------1------TT--------TT---------------#------------TT----#---------TT--------------------------TT---2--------------------#---------------##-----##-------F---
-M----------------K------TT---ETT--------------EEETT--L---k-rT---yy----------#---------y--TT---y------y---TT------------o------%------TT------------------------#----y--y------###-k---##-------#---
XXXXXXXXXXXXXXXXXXXXXXXXXXXXXXXXXXXXXX---XXXXXXXXXXXXXXXXXXXXXXXXXXXXXXXXXXXKXXXXXXXX*XXXXXXXXXXXXXXXXXXXXXXXXXXXXXXXXXXXXX--XXXXXXXXXXXXXXXXXXXX---XXX--XXXXXXXX--XXXXXXXXXXXXXXXXXXXXXXXXXXXXXXXXX
XXXXXXXXXXXXXXXXXXUXXXXXXXXXXXXXXXXXXX---XXXXXXXXXXXXXXXXXXXXXXXXXXXXXXXXXXXXXbXXXXXXXXXXXXXXXXXXXXXXXXXXXXXXXXXXXXXXXXXXXX--XXXXXXXXXXXUXXXXXXXX---XXX--XXXXXXXX--XXUXXXXXXXXXXXXXXXXXXXXXXXXXXXXXX
