---------------X------------------------------------------------------------------------------------
---------------X------------------------------------------------------------------------------------
---------------X------------------------------------------------------------------------------------
---------------X------------------------------------------------------------------------------------
---------------X------------------------------------------------------------------------------------
---------------X------------------------------------------------------------------------------------
----------------------------------------------------------------------------------------------------
----------------------------------------------------------------------------------------------------
----------------------------------------------------------------------------------------------------
----------------------------------------------------------------------------------------------------
----------------------------------------------------------------------------------------------------
----------------------------------------------------------------------------------------------------
----------------------------------------------------------------------------------------------------
----------------------------------------------------------------------------------------------------
----------X-----------------------------X-----------------------------------------------------------
----------X-----------------------------X---------------------X-------------------------------------
----------X-----------------------------X---------------------X-------------------------------------
----------X-----------------------------X---------------------X-------------------------------------
XXXXXXXXXXXXXXX-XXXXXXXXXXXXXXXXXXXXXXXXXXXXXXXXXXXXXXXXXXXX--XXXXXXXXXXXXXXXXXXXXXXXXXXXXXXXXXXXXXX
XXXXXXXXXXXXXXX-XXXXXXXXXXXXXXXXXXXXXXXXXXXXXXXXXXXXXXXXXXXXXXXXXXXXXXXXXXXXXXXXXXXXXXXXXXXXXXXXXXXX
