----------------------------------------------------------------------------------------------------------------------------------------------------------------------------------------------------
----------------------------------------------------------------------------------------------------------------------------------------------------------------------------------------------------
----------------------------------------------------------------------------------------------------------------------------------------------------------------------------------------------------
----------------------------------------------------------------------------------------------------------------------------------------------------------------------------------------------------
----------------------------------------------------------------------------------------------------------------------------------------------------------------------------------------------------
--------------------------------------------------------------------------------------------------------------------------------------------------------------------------------------y-------------
----------------Q-------------------------Q-Q---------------------1-------------------------------------------------------QQQQ--------------------------------------------------------##------------
-------------------------------------------------------------------------------oooo----------oooo------------oooo-------------------------------------------------------------------y###------------
------------------------------------------------------------------------------------------------------------------------------------------------------------------------------------####------------
------------------------------oo--------------------------------------------------------------------------------------------y------------------------------------------------------#####------------
----------------?------------o--o---------Q-Q-------------------QQQQ----------------------TT--------------TT------------QQ?SSQQQ--------------------------------------------------######---C--------
------------TT---------------------------------------------------------------#------------TT--------------TT----------------------------------------------------#----------------#######------------
------------TT---------------------------------------------------------------#------------TT--------------TT--------------------------TT------------------------#---------------########--------F---
-M----------TT-----------------------y--------y------------------yy----------#---------y--TT---y------y---TT--------------------------TT------------------------#----y--y------#########--------#---
XXXXXXXXXXXXXXXXXXXXXXX--XXXXXXXXXXXXXXXXXXXXXXXXXXX----XXXXXXXXXXXXXXXXXXXXXXXXXXXXXXXXXXXXXXXXXXXXXXXXXXXXXXXXXXXXXXXXXXX--XXXXXXXXXXXXXXXXXXXX---XXX--XXXXXXXX--XXXXXXXXXXXXXXXXXXXXXXXXXXXXXXXXX
XXXXXXXXXXXXXXXXXXXXXXX--XXXXXXXXXXXXXXXXXXXXXXXXXXX----XXXXXXXXXXXXXXXXXXXXXXXXXXXXXXXXXXXXXXXXXXXXXXXXXXXXXXXXXXXXXXXXXXX--XXXXXXXXXXXXXXXXXXXX---XXX--XXXXXXXX--XXXXXXXXXXXXXXXXXXXXXXXXXXXXXXXXX