----------
----------
----------
----------
----------
----------
----------
----------
----------
----------
----------
--M----F--
XXXXXXXXXX
XXXXXXXXXX